NO ./textures/wall1.png
SO ./textures/wall2.png
WE ./textures/wall3.png
EA ./textures/wall4.png

F 220,100,0
C 225,30,0
          111111111111111
       11110000000000001
     11100000000000000001111
   1110000000000000000000000111
  110000000000000N00000000000011
  110000000000000000000000000011
  110000000011111111110000000011
   11000000111       11100000011
    110000011         1100000011
     11100001         110000000111
       111001         11000001111
         11101
               11000011
           1111111111111111
