NO ./textures/wall1.png
SO ./textures/wall2.png
WE ./textures/wall3.png
EA ./textures/wall4.png

F 220,100,0
C 225,30,0
          111111111111111
       11110000000000001111
     111000111111111100000111
   1110001           1000000111
  1100001  111111111 10000000011
  1100001  100000001 10000000011
  1100001  101111101 11111000011
   1100001 100000001      100011
    11000011000000001      10011
     11100001111111101 1111000111
       111001         100001111
         11101       11000011
           1111111111111111
