NO ./textures/wall1.png
SO ./textures/wall2.png
WE ./textures/wall3.png
EA ./textures/wall4.png

F 220,100,0
C 225,30,0
1111111111111111111111111
1000000000000000000000001
1011111111111111111111101
1010000000000000000000101
1010111111111111111100101
1010100000000000000100101
1010101111111111110100101
1010101000000000010100101
1010101011111111010100101
1010101010000001010100101
1010101010111111010100101
1010101010100001010100101
1010101010101111010100101
1010101010101000010100101
1010101010101011110100101
1010101010101010000100101
1010101010101010111100101
1010101010101010100000101
1010101010101010101111101
100000000000E000000000001
1111111111111111111111111
