NO ./textures/cobblestone.png
EA ./textures/cobblestone.png
SO ./textures/cobblestone.png
WE ./textures/cobblestone.png

C 200,200,200
F 100,100,100

1111111111111110
11100000000111 
11000000000011 
10000000000001 
10000000000001 
10000000000001 
10000000000001 
11000000000011 
11111011011111 
10000000000001 
10000000000001 
10000000000000 
10000000000000 
10000000000000 
10000011000001
